veux	vouloir
voudrai	vouloir
voudrais	vouloir
souhaiter	vouloir
souhaite	vouloir
souhaiterai	vouloir
souhaiterais	vouloir
aimer	vouloir
aimerai	vouloir
aimerais	vouloir
avoir	vouloir
affiche	vouloir
afficher	vouloir
sélectionner	vouloir
sélectionne	vouloir
lister	vouloir
recencer	vouloir
recence	vouloir
quels	vouloir
quel	vouloir
quelles	vouloir
quelle	vouloir
chercher	vouloir
cherche	vouloir
donner	vouloir
donne	vouloir
trouve	vouloir
trouver	vouloir
récupère	vouloir
récupérer	vouloir
existe	vouloir
exister	vouloir
désirer	vouloir
désire	vouloir
désirerai	vouloir
désirerais	vouloir
parle	parler
parlent	parler
parlant	parler
parlerait	parler
parleraient	parler
traiter	parler
traite	parler
traitent	parler
traitant	parler
traiterait	parler
traiteraient	parler
sujet	parler
contenir	parler
contient	parler
contiennent	parler
contenant	parler
contiendrait	parler
contiendraient	parler
composer	parler
compose	parler
composent	parler
composant	parler
composerait	parler
composeraient	parler
citer	parler
cite	parler
citent	parler
citant	parler
citerait	parler
citeraient	parler
concerner	parler
concerne	parler
concernent	parler
concernant	parler
concernerait	parler
concerneraient	parler
porter	parler
porte	parler
portent	parler
portant	parler
porterait	parler
porteraient	parler
écrit	parler
écrits	parler
écrire	parler
écrivant	parler
posséder	parler
possède	parler
possèdent	parler
possédant	parler
évoquer	parler
évoque	parler
évoquent	parler
évoquant	parler
évoquerait parler
évoqueraient	parler
propos	parler
provenir	parler
provient	parler
proviennent	parler
provenant	parler
où	dont
articles	article
bulletins	article
bulletin	article
fichiers	article
fichier	article
contacts	auteur
contacter	auteur
auteurs	auteur
personnes	auteur
personne	auteur
individus	auteur
individu	auteur
créateurs	auteur
créateur	auteur
titres	titre
rubriques	rubrique
catégories	rubrique
catégorie	rubrique
dates	date
période	date
durée	date
publié	date
publiés	date
datant	date
datent	date
paru	date
antérieur	date
antérieurs	date
pas	non
sans	non
je	0
sur	0
que	0
qui	0
qu'	0
pour	0
à	0
au	0
aux	0
l'	0
le	0
la	0
les	0
d'	0
de	0
des	0
du	0
pour	0
moi	0
mon	0
mes	0
sont	0
est	0
ont	0
a	0
un	0
une	0
par	0
en	0
dans	0
plus	0
moins	0
ce	0
ces	0
celles	0
celle	0
ceux	0
cet	0
cette	0
avec	0
mais	0
tout	0
tous	0
toute	0
toutes	0
liste	0
listes	0
ne	0
n'	0
t'	0
y	0